/** 
 * FLOORS layer 
 * tilesheet: floor_wood_opengameart 
 */ 
protected static var FLOORS:Array = new Array( 
	0, 0, 0, 0, 0, 0, 0, 0, 0, 0, 0, 0, 0, 0, 
	0, 0, 0, 0, 0, 0, 0, 0, 0, 0, 0, 0, 0, 0, 
	0, 0, 0, 0, 0, 0, 0, 0, 0, 0, 0, 0, 0, 0, 
	0, 0, 0, 0, 0, 0, 0, 0, 0, 0, 0, 0, 0, 0, 
	0, 0, 0, 0, 0, 0, 0, 0, 0, 0, 0, 0, 0, 0, 
	0, 0, 0, 0, 0, 0, 0, 0, 0, 0, 0, 0, 0, 0, 
	0, 0, 0, 0, 0, 0, 0, 0, 0, 0, 0, 0, 0, 0, 
	0, 0, 0, 0, 0, 0, 0, 0, 0, 0, 0, 0, 0, 0, 
	0, 0, 0, 0, 0, 0, 0, 0, 0, 0, 0, 0, 0, 0, 
	0, 0, 0, 0, 0, 0, 0, 0, 0, 0, 0, 0, 0, 0, 
	0, 0, 0, 0, 0, 0, 0, 0, 0, 0, 0, 0, 0, 0, 
	0, 0, 0, 0, 0, 0, 0, 0, 0, 0, 0, 0, 0, 0, 
); 

/** 
 * WALLS layer 
 * tilesheet: walls_opengameart 
 */ 
protected static var WALLS:Array = new Array( 
	0, 0, 0, 0, 0, 0, 5, 5, 5, 5, 5, 0, 0, 0, 
	0, 0, 0, 0, 0, 0, 6, 0, 0, 0, 8, 0, 0, 0, 
	0, 0, 0, 0, 0, 0, 6, 0, 0, 0, 8, 0, 0, 0, 
	0, 0, 0, 0, 0, 0, 6, 0, 0, 0, 8, 0, 0, 0, 
	1, 2, 2, 2, 3, 0, 6, 0, 0, 0, 8, 0, 0, 0, 
	6, 0, 0, 0, 8, 2, 2, 2, 9, 2, 2, 0, 0, 0, 
	6, 0, 0, 0, 4, 0, 0, 0, 0, 0, 0, 5, 5, 3, 
	6, 0, 0, 0, 8, 2, 2, 2, 2, 3, 4, 0, 0, 8, 
	5, 5, 5, 5, 5, 0, 0, 0, 0, 8, 0, 0, 0, 8, 
	0, 0, 0, 0, 0, 0, 1, 7, 0, 8, 0, 0, 0, 8, 
	0, 0, 0, 0, 0, 0, 6, 0, 0, 8, 0, 0, 0, 8, 
	0, 0, 0, 0, 0, 0, 2, 2, 2, 2, 2, 2, 2, 2, 
); 
